{
    " ": 1,
    "#": 2,
    "0": 3,
    "1": 4,
    "2": 5,
    "3": 6,
    "4": 7,
    "5": 8,
    "6": 9,
    "7": 10,
    "8": 11,
    "9": 12,
    "А": 13,
    "Б": 14,
    "В": 15,
    "Г": 16,
    "Д": 17,
    "Е": 18,
    "Ж": 19,
    "З": 20,
    "И": 21,
    "Й": 22,
    "К": 23,
    "Л": 24,
    "М": 25,
    "Н": 26,
    "О": 27,
    "П": 28,
    "Р": 29,
    "С": 30,
    "Т": 31,
    "У": 32,
    "Ф": 33,
    "Х": 34,
    "Ц": 35,
    "Ч": 36,
    "Ш": 37,
    "Щ": 38,
    "Ъ": 39,
    "Ы": 40,
    "Ь": 41,
    "Э": 42,
    "Ю": 43,
    "Я": 44,
    "-": 0
}