{
    "1": " ",
    "2": "#",
    "3": "0",
    "4": "1",
    "5": "2",
    "6": "3",
    "7": "4",
    "8": "5",
    "9": "6",
    "10": "7",
    "11": "8",
    "12": "9",
    "13": "А",
    "14": "Б",
    "15": "В",
    "16": "Г",
    "17": "Д",
    "18": "Е",
    "19": "Ж",
    "20": "З",
    "21": "И",
    "22": "Й",
    "23": "К",
    "24": "Л",
    "25": "М",
    "26": "Н",
    "27": "О",
    "28": "П",
    "29": "Р",
    "30": "С",
    "31": "Т",
    "32": "У",
    "33": "Ф",
    "34": "Х",
    "35": "Ц",
    "36": "Ч",
    "37": "Ш",
    "38": "Щ",
    "39": "Ъ",
    "40": "Ы",
    "41": "Ь",
    "42": "Э",
    "43": "Ю",
    "44": "Я",
    "0": "-"
}